#Example: Large parts of Africa and south east Asia
tropical = {

}

arid = {

	# Akan
	399 397 398 396 383 395 401 392 393 390
	
	# North Salahad
	453 454 455 459 456 457 460 461 465 470 490 502 592 479 480 481 482 483 484 486 487 485 488 489 504 505 492 493 495 497 498 499 500 501 458

}

arctic = {

}

#Example: Most of Europe north of med.
mild_winter = {

	# Businor
	363 362
	
	# Lencenor
	93 94 106 83 82 90 96 58 102 104 105 78 67 74 68 61 69 114 108 79 80 95 70 71 77 117 112 110 111 113 121 75 92 107 87 119 59 33 32 34 38 72 73 128 123 124 125
	
	# Small Country
	63 66 130 131 132 136 162 161 164 160 159 166 163 139 137 133 158 152 135 134 
	
	# Dragon Coast
	
	# West Dameshead
	10 13 15 17 28 23 24 27 26 41 42 57 18 153 154 156 157 151 11 8 168 3 6 5 2 9 20 31 19 22 16 21 30
	
	# East Dameshead
	45 25 276 330 37 277 899 52 53 54 55 56 29 292 328 281 297 279 910 298 327 906 289 287 282 284 329 296 278
	
	# Esmaria
	275 269 265 905 917 909 273 272 271 900 266 267 264 260 911 259 262 255 254 908 280 274 916 333 268 44
	
	# The Borders
	409 410 411 412 413 416 420 295 921 922
	
	# Dameshead
	60 155 205 216 251 233 234 915 914 214 215 207 209 347 249
	
	# Dostanor and Daravan's Folly
	445 451 447 448 449 

}

#Example: Inland Europe & Scandinavia
normal_winter = {

	# Lencenor
	116

	# Small Country
	7 348 206 210 103 147 165 149 76 12
	
	# Dragon Coast
	170 145 148 144 169 146 177 178 176 175 172 173 174 181 171 129 141 142 143 126 213 336 138 140 122
	
	# East Dameshead
	299 898
	
	# Esmaria
	308 309 302 901 301 263 270
	
	# The Borders
	303 304 305 306 294 300 332 311 320 310 912 307 318 907 903 312 326 321 902 323 324 322 421 325 904 418 419 313 316 317 319 315 913 414 415 918 919 417 920
	
	# Dameshead
	208 219 235
	
	# Forlorn Vale
	261 351 352 360 359 353 354 355 356 361 423 314 422 779 778 777 775 
	
	# Alenic Frontier - Arbaran places
	253 236 252 349 238 244 334 250 256 342 258 357 358 257 248 245 246 247 335
	
	# Alenic Frontier - Gawed places
	191 345 194 192 193 201 202 203 204 340 217 218 224 237 239 243 338 221 222 223 341 346 337 220 339 225 240 226 227 228 241 229 230 232 231 343 344 242
	
	# Corvuria/Dostanor
	424 427 428 426 425 430 441 440 439 438 431 432 433 434 435 437 436 429 444 443 442 446 450
	
	# Escann
	710 725 726 729 749 730 727 750 728 751 753 758 759 761 763 762 757 760 767 756 792 765 764 766 768 769 770 771 776 780 772 773 774 781 782 785 786 787 789 784 783 788 790 793 794 795 796 
	799 791 797 798 800 808 801 809 810 802 803 805 807 806 812 811 815 814 813 816 817 818 819 886 887 889 890 892 893 894 820 822 824 826 827 821 825 823 829 830 828 831 832 833 834 835 836 755 837 839 754 842 747 848
	840 843 845 847 841 853 855 851 844 854 864 869 865 866 874 873 883 891 888 885 875 876 877 856 857 
}

#Example: Russia & Lappland
severe_winter = {
	# Lencenor
	62 64 65 120
	
	# Businor
	377 364
	
	# Dragon Coast
	167 183 185 187 186 189 188 190 199 198 197 200 150 211 212 179 180 182 184 
	
	# West Dameshead
	4
	
	# Forlorn Vale aka that Silent Repose Area
	350 
	
	# Alenic Frontier
	195 196
	
	# Escann
	895 896 897 746 743 850 849 846 852 858 860 861 868 870 863 872 878 879 867 871 880 881 882 884 859 862 741 745 742 744 748 732
}

impassable = {
	2426 1173 1779 1781 1782 1783 1784 1785 1786 1787 1788 1789 1790 1791 1793 1794 1795 1796 1797 1798 1799 1801 1802 1803 1804 1805
	1806 1807 1808 1810 1811 1812 1814 1950 2194 2200 2251 2334 2608 2740 2425 2936 3415 3416 3417 3418 3419 3590 3591 3592 3593 3594 3595 
	3596 3597 3598 3599 3621 3622 3623 3624 3625 3626 3427 3628 3629 3630 3631 3632 3633 3634 3635 3636 3437 3638 3639 4146
	4153 4154 4155 4156 4157 4159 4160 4161 4162 4167 4168 4169 4170 4172 4177 4178 4179 4276 4321 4322 4328
	
	
}