europe = {
	1 2 3 4 5 6 7 8 9 10 11 12 13 14 15 16 17 18 19 20 21 22 23 24 25 26 27 28 29 30 31 32 33 34 35 36 37 38 39 40 41 42 43
	44 45 46 47 48 49 50 51 52 53 54 55 56 57 58 59 60 61 62 63 64 65 66 67 68 69 70 71
	72 73 74 75 76 77 78 79 80 81 82 83 84 85 86 128 129 130 131 132 133 134 165 166
	87 88 89 90 91 92 93 94 95 96 97 98 99 100
	101 102 103 104 105 106 107 108 109 110 111 112 113 114 115 116 117 118 119 120 121
	122 123 124 125 126 127 135 136 137 138 139 140 141 142 143 144 145 146 147 148 149 150 151 152 153 154 155
	156 157 158 159 160 161 162 163 164 167 168 169 170 171 172 173 174 175 176 177 178 179 180 181 182 183 184 185 186 187
	188 189 190 191 192 193 194 195 196 197 198 199 200 201 202 203 204 205 206 207 208 209 210 211 212 213 214 215 216 217 218 219 220 221 222 223 224 225 226
	227 228 229 230 231 232 333 233 234 235 236 237 238 239 240 241 242 243 244 245 246 247 248 249 250 251 252 253 254 255 256 257 258 259 260 261 262 263 264 265 266 267 268 269 270 271 272 273 274
	275 276 277 278 279 280 281 282 283 284 285 286 287 288 289 290 291 292 293 294 295 296 297 298 299 300 301 302
	303 304 305 306 307 308 309 310 311 312 313 314 315 316 317 318 319 320 321 322 323 324 325 326 327 328 329 330 331 332 
	366 367 368 369 370 371 372 373 374 375 376 422 423 425
	
	770 771 767 4146
	


	#Anbennar New 
	899 910 905 916 900 917 911 908 914 915 912 901 909 902 898 903 904 906 907 913 918 838
	348 347 346 345 344 343 342 341 340 339 338 337 336 335 334 349 350 351 352 353 354
	355 356 357 358 359 360 361 362 363 365 364 377 378 379 380 569 394 587 579 923 408 576 575
	409 410 411 412 413 414 415 416 417 418
	419 420 421 424 426 427 428 429 430 431 432 433 434 435 436 437 438 439
	440 441 442 443 444 445 446 447 448 449 450
	919 920 921 922 451 452 506 507 508 509 510 511 524
	
	#Gerudia
	952 953 954 955 956 957 958 959 960 1001
	961 962 963 964 965 966 967 968 969 970 971 972 973 974 975 976 977 978 979 980 981
	982 983 984 985 986 987 988 989 990 991 992 993 994 995 996 997 998 999 1000
	2426 2829 2830 2831 2832 2833 2835 2834
	
	
	#Escann
	694 695 696 697 698 699 700 701 702 703
	704 705 706 707 708 709 710 711 712 713 714 715 716 717 718 719 720 721 722 723 724
	725 726 727 728 729 730 731 732 733 734 735 736 737 738 739 740
	741 742 743 744 745 746 747 748 749 750 751 752 753 754 755 756 757 758 759 760 761
	762 763 764 765 766 768 769 772 773 775 776 777 778 779 780 781 782
	783 784 785 786 787 790 791 792 793 794 795 796 797 799 800 801 802 803
	804 805 806 807 808 809 810 811 812 813 814 815 816 817 818 819 820 821 822 823 824
	825 826 827 828 829 830 831 832 834 833 788 789 774 798
	835 836 837 839 840 841 842 843 844 845 846 847 848 849 850 851 852 853 854 855
	856 857 858 859 860 861 862 863 864 865 866 867 868 869 870 871 872 873 874 875 876
	877 878 879 880 881 882 883 884 885 886 887 888 889 890 891 892 893 894 895 896 897
	1782
	
	#New Trade Nodes
	1286 1289 1256 1322 1294 1263 1292 1296 1252
	
	# New Impassables
	4153 4154 4155 4156 4157 4159 4160 4161 4162
	
}

serpentspine = {
	#Serpent's Vale
	4125 4129 4123 4142 4131 4143 4158 4151 4152 4166 4164 4145
	4194 4192 4193 4195 4197 4196 4199 4198 4201 4202 4200 4190 4191 4189 4183 4182 4181
	4185 4186 4187 4188 4180 4184 4176 4171 4173 4174 4175

	#West Dwarovar
	4121 4122 4128 4119 4149 4120 4203 4204 4205 4207 4208 4206
	4209 4210 4211 2897 2896 2863 2864 2935 2865 2898 2899 2870 2869 4163 2868 4022 2995 4021 4023
	4025 4024 4026 2866 2867 2871 4074 4096 4054 4044 4045 4046 4047 4048 4049 4055 4043 2872 2933
	4050 4051 4052 4053 2873 2874 2934 4065 4067 4066 4061 4060 4059 4057 4058 2875 2932 4104
	2931 2986 2876 2988 4165 4212 4213 4150 4062 4063 4064 2989 2990 2991 4236 4141 4144 2992 2993 2994
	2996 2997 2998 4118 4147 4148 4130 2999 3000 3001 3002 3003 4020 4076 4075 4077 4105 4056 4237 4097
	4068 4069 4070 4071 4072 4073 2877 2937 2878 4101 4102 2879 2880 4103 2963 2881 2882 2883 4029 2884
	
	#Middle Dwarovar
	2885 4028 4217 2886 2887 2888 4227 4228 4229 4215 4214 4078 2889 2890 2891 4239 4080 4084 4079
	4081 4083 4085 4027 2892 2893 4216 4124 4082 4230 4088 4110 4108 4109 4108 4107 4086 4087 4089
	4106 4092 4095 4094 2894 2895 2914 4220 4219 4223 4231 4091 4221 4222 4111 4112 4113 4114 4090 4218
	
	#Serpentreach
	4039 4038 4037 4040 4042 4041 2949 4036 2985 2984 2951 2952 4035 2982 2978 2983 2977 2974
	2981 2980 2979 4099 2975 4098 2970 2968 2969 4240 2962 2946 2973 2976 2972 2971 2967 2966 2965 2964
	2945 2944 2943 2942 4126 4100 4127 2961 2959 2958 2960 2947 2948 2950 4093 2955 2954 2956
	2957 4034 4032 4031 4033 4030 2941 4238 2939 2940 2987
	
	#Tree of Stone
	4242 4243 4244 4245 4246 4247 4248 4249 4250 4251 4252 4253 4254 4255 4256 4257 4258 4259 4260 4261 
	4262 4263 4264 4265 4266 4297 4298 4300 4284 4277 4279 4280 4281 4271 4267 4282 4269 4270 4272
	4292 4274 4275 4268 4283 4285 4287 4286 4288 4293 4294 4295 4296 4299 4278 4273 4290 4289 4291
	
	#Jade Mine
	4301 4302 4303 4304 4305 4306 4307 4308 4309 4310 4314 4315 4316 4317 4318 4319 4320 4359 4360 4312
	4350 4311 4313 4339 4338 4337 4336 4335 4334 4351 4352 4348 4349 4324 4325 4326 4353 4327 4329 4330 
	4331 4332 4344 4354 4345 4355 4342 4341 4340 4323
	
}

asia = {
	1173
}

africa = {

	1793 1794
	
	#Anbennar
	462 463 466 467 473 475 468 464
	381 382 383 384 385 386 387 388 389 390 391 392 393 395 396 397
	398 399 400 401 402 403 404 405 406 407 453 454 455 456 457 458 459 460
	461 465 469 470 471 472 474 476 477 478 479 480
	481 482 483 484 485 486 487 488 489 490 491 492 493 494 495 496 497 498 499 500 501
	502 503 504 505 512 513 514 515 516 517 518 519 520 521 522 523
	525 526 527 528 529 530 531 532 533 534 535 536 537 538 539 540 541 542 543 544
	545 546 547 548 549 550 551 552 553 554 555 556 557 558 559 560 561 562 563 564 565
	566 567 568 570 571 572 573 574 577 578 
	580 581 582 583 584 585 586 588 589 590 591 592 593 594 595 596 597 598 599
	600 601 602 603 604 605 606 607 608 609 610 611 612 613 614 615 616 617 618 619 620
	621 622 623 624 625 626 627 628 629 630 631 632 633 634 635 636 637 638 639 640 641
	642 643 644 645 646 647 648 649 650 651 652 653 654 655 656 657 658 659 660 661
	662 663 664 665 666 667 668 669 670 671 672 673 674 675 676 677 678 679 680 681 682
	683 684 685 686 687 688 689 690 691 692 693 4117
	
	#New Trade Nodes
	1300 1312 1305 1309 1312 1310 
	
	#Far Salahad
	2900 2901 2902 2903 2904 2905 2906 2907 2908 2909 2910 2911 2912 2913 2915 2916
	2917 2918 2919 2920 2921 2922 2923 2924 2925 2926 2927 2928 2929 2930
}

north_america = {

	# 924 925 926 927 928 929 930 931 932 933 934 935 936 937 938 939
	# 940 941 942 943 944 945 946 947 948 949 950 951 
	
	# 1002 1003 1004 1005 1006 1007 1008 1009 1010 1011 1104 1105

	
	# #North Aelantir
	# 1012 1013 1014 1015 1016 1017 1018 1019 1020 1021 1022 1023 1024 1025 1026 1027 1028
	# 1029 1030 1031 1032 1033 1034 1035 1036 1037 1038 1039 1040 1041 1042 1043 1044 1045
	# 1046 1047 1048 1049 1050 1051 1052 1053 1054 
	
	# #Ruin
	# 1055 1056 1057 1058 1059 1060 1061 1062
	# 1063 1064 1065 1066 1067 1068 1069 1070 1071 1072 1073 1074 1075 1076 1078 1080
	# 1084 1085 1086 1087 1088 1089 1090 1091 1092 1093 1094 1095 1531 1083
	# 1077 1079 1081 1082 1096 1097 1100 1101 1102 1103 1106 
	# 1098 1099 
	
		928 929 930 931 932 933 934 935 936 937 938 939 940 941 942 943 944 945 946 947 948 1002 1003 1004 1005 1006 1007 1008 1009 1010 1011
		2788 2126 2230 2828
		
		#Trollsbay
		1050 1049 1048 1047 1046 1045 1037 1035 1036 1033 1034 1038 1039 1043 1044 1042 1041 1040 1032 1030 1029 1028 1031 1027 1026 1025 1024 1023 1021 1020 1019 1051 1018 1022
		1992 1871 1991 2449 1959 1127 1126 1129 1128 2609 1961 1132 1131 2476 1956 2563 1873 1901 2685 1867 2410 1953 1952 1958 1954 1880 2614 1866 2741 1869
		1933 1934 1937 1938 1943 1949 1935 1936
		
		#Reapers Coast
		1941 1930 1940 1865 1951 1925 1939 1942 1948 1944 1955 1947 1876 1945 1946 1870 1868 1872 1960 1130
		
		#Bloodgroves
		1123 1995 2459 1012 1117 1124 1119 2538 2450 2548 1996 1114 1116 1115 2557 2208 1113 2283 1111 1110 2437 1121 1120 1998 1999 1014 1013 1015 1016 
		
	
	#New Trade Nodes
	1519 1500 1504
	
	1773 1774 1194 1766 1193 1792 2821 2843 1800 1815 1816 1817 1818 1823 1824 1846 1847 1848 1849 1859 1851 1852 1853 1854 1855 1856 1857 1858 1859 1860 1861 1862 1863 1864 2729 1850 2842 1838 1839 1840 1841 1842 1843 1844 1845 1836 1879 1957 2855 1845 1931 2854 1882 2856 1881 
	1837 1742 1198 2662 2838 2488 2840 2742 1197 1196 2819 2784 2807 2781 2811 2837 2839 2862 2814 1820 2813 2812 2808 2809 1819 1159 1160 1162 1163 1164 1165 1166 1167 1168 1169 1170 1171 1172 1174 1175 1176 1177 1178 1179 1180 1181 1182 1183 1184 1185 1186 1187 1188 1189 1190 1191 1192 1745 1747 1748 1750 1755 1756 1757 1758 1759 1760 1764 1765 1767 
	2815 2857 1828 1829 1830 1831 1832 1833 1834 1835 2836 2844 2606 2615 2817 2783 2858 2757 2860 1877 1874 2861 2859 2810 2816 2841 1133 1134 1135 1136 1137 1138 1139 1140 1141 1142 1143 1144 1145 1146 1147 1148 1149 1150 1151 1152 1153 1154 1155 1156 1157 1158 1159 1161 2818 1821 1878 1822 1825 1826 1827 
	1772 1989 1769 1753 1762 1770 2798 2799 2749 1768 1752 1751 1761 1754 1746 1749 1247 2482 1249 1248 2801 2802 2800 2820 1273 1245 1246 1234 1230 2516 1243 1244 1227 1228 1318 1235 1763 2569 1492 
	2797 1984 1982 2047 1967 1776 1777 1778 1963 1813 1809 1962 1780 1964 1965 1971 1981 1777 1983 1966 1968 1970 1775 1979 1972 1973 1987 1693 
	1118 1997 2027 2036 2025 2003 2004 2005 2006 2007 2013 2024 2016 2017 2050 2015 1125 1993 1875 2011 2014 2012 1990 1771 2503 1988 2002 1969 1986 1985 1978 1122 1978 1974 2006 1994 1109 1112 1690 2008 2026 2009
	2063 2062 2061 2825 2051 2052 2053 2054 2055 2056 2056 2057 2058 2059 2060 2010 2018 2019 2020 2021 2022 2023 2028 2029 2030 2031 2032 2033 2034 2035 2037 2038 2039 2040 2041 2042 2043 2044 2045 2048 2049 2046 1683 
	2095 2096 2097 2098 2099 2100 2101 2102 2103 2104 2105 2106 2107 2108 2109 2110 2111 2112 2113 2114 2115 2822 2823 2826 2827 2138 2824 2094 
	2079 2080 2081 2082 2083 2084 2085 2086 2087 2088 2089 2090 2092 2116 2117 2118 2119 2120 2121 2122 2123 2126 2127 2128 2129 2130 2131 2132 2133 2134 2136 2139 2140 2141 2142 2143 2144 2145 2146 2147 2148 2149 2150 1720 
	2078 2077 2076 2075 2074 2073 2072 2070 2071 2069 2068 2067 2066 2065 2064 2151 2152 2153 2154 2155 2156 2157 2158 2159
		924 949 950 951 2787 1205 1202 1203 1204 1208 1207 1210 1209 1212 1211 2851 2852 2846 2847 2845 2849 1201 2848 2853 1217 1215 1214 1213 1206 1218 1224 1226 1233 1232 1219 1223 1220 1225 1222 1229 1231 2789 2790 2791 2792 2793 2794 2795 2796 1241 1240 1238 1237 1236 1200 1216 1199 1744 1743 1242 2850 1239 1576 
	926 925 927 924 949 950 951
}

south_america = {

		1059 1060 1061 1062 1063 1064 1065 1066 1067 1068 1069 1070 1071 1072 2137 1107 1108
				
		#Soruin
		1306 1100 2175 2177 2176 2178 2180 2199 2179 2190 2191 2192 2186 2187 2181 2182 2197 2198 2359 2189 2188 2193 2195 2196 2201 2202 2203 2204 2205 2183 2184
		
		#Ruined Isles
		1075 1076 1077 1078 1079 1080 1082 1081 1083 1084 1085 1086 1087 1101 1103 1088 1089 1090 1091 1100 1092 1093 1096 1094 1095 1097 1098 1099 1102 1104 1105 1106 1053 1052 1017 
		1055 1058 1073 1074 1056 1057 2125 1221 2093 2124 2091 2135 1054

		#West Effelai
		2355 2354 2394 2352 2353 2351 2357 2356 2358 2348 2349 2350 2215

		#Leechdens
		2211 2212 2210 2213 2207 2185 2206 2209 2214 2216 2217 2228 2229 2222 2395 2218 2219 2221 2220 2265 2225 2282 2226 2227 2233 2223 2224 2234 2233 2232 2231 2231 1511 

		#South Effelai
		2363 2364 2365 2376 2375 2266 2343 2264 2267 2378 2377 2366 2339 2341 2342 2340 2370 2371 2369 2367 2368 2379 2381 2380 2373 2374 2373 2372 2373 2374 2373 2372 2370 2371 2369 2367 2368 2379 2381 2380 

		#East Effelai
		1539 2273 2276 2275 2272 2274 2279 2277 2806 2246 2805 2245 2803 2804 2242 2240 2243 2244 2239 2291 2238 2290 2289 2292 2278 2288 2287 2237 2286 2280 2281 2285 2236 2235 2284 2241 2271 2270 2293 2247 2269 2268 2248 2249 2250 2252 2253 2254 2255 2256 2259 2260 2257 2262 2261 2258 2263 


		#Dry Coast
		2512 2336 2345 2335 2333 2332 2346 2331 2347 2308 2337 2307 2309 2338 2344 2306 2305 2301 2304 2302 2300 2303 2294 2299 2298 2295 2296 2297 2311 2315 2313 2312 2314 2316 2317 2318 2319 2320 2321 2322 2323 2324 2325 2326 2327 2328 2513 1607 
		
		
		2522 2532 2523 2531 2517 2534 2536 2518 2519 2520 2533 2535 2521 2541 2543 2544 2546 2539 2537 2515 2514 2501 2540 2511 2510 2508 2509 2499 2502 2500 2507 2504 2506 2505 2498 2495 2551 2547 2549 2545 2564 2329 2330 1544 
		2467 2466 2472 2470 2469 2474 2473 2477 2475 2478 2481 2480 2483 2486 2487 2485 2489 2479 2484 2490 2491 2494 2552 2492 2554 2553 2555 2556 2493 2496 2497 2542 2528 2529 2527 2566 2565 2570 2568 2571 2550 2558 
		2460 2461 2462 2463 2464 2468 2607 2605 2604 2587 2586 2584 2573 2572 2465 2603 2591 2610 2657 2655 2654 2652 2583 2585 2612 2611 2580 2582 2574 2650 2651 2656 2653 2593 2592 2594 2601 2602 1662 
		2588 2590 2589 2579 2578 2577 2576 2575 2568 2571 2570 2560 2567 2566 2565 2561 2525 2524 2526 2562 2559 2527 2527 2529 2528 2542 2530 2581 2613 2589 1546 
		2691 2638 2647 2704 2703 2637 2646 2667 2639 2644 2664 2663 2632 2631 2629 2627 2666 2661 2659 2628 2649 2658 2665 2660 2711 2705 2702 2712 2648 2710 2715 
		2684 2690 2692 2717 2716 2682 2697 2694 2693 2701 2686 2687 2688 2689 2635 2634 2626 2640 2641 2642 2643 2645 2625 2624 2634 2622 2621 2623 2620 2619 2618 2617 2616 2630 2636 2633 2683 1731 
		2750 2751 2748 2747 2746 2779 2780 2752 2753 2782 2744 2778 2743 2745 2777 2772 2738 2739 2773 2775 2774 2776 2785 2737 2771 2770 2769 2736 2768 2733 2767 2764 2732 2754 2786 2766 2765 2762 2763 2731 2760 2755 2761 2730 2758 2756 2759 2728 2727 2726 2734 2735 2718 2725 2724 2681 2680 2679 2695 2678 2696 2700 2677 2706 2676 2719 2720 2721 2722 2599 2600 2723 2596 2597 2598 2670 2669 2668 2671 2673 2698 2699 2707 2675 2674 2595 2714 2672 2708 2709 2713 1741 
		2400 2399 2398 2397 2396 2391 2392 2393 2390 2389 2388 2386 2401 2405 2417 2446 2406 2413 2412 2411 2409 2407 2408 2402 2403 2404 2418 2419 2420 2414 2415 2431 2445 2423 2443 2427 2444 2421 2422 2428 2424 2429 2430 2439 2432 2441 2447 2440 2433 2434 2436 2435 2438 2442 2448 2451 2452 2453 2454 2416 2385 2458 2457 1195 2455 2382 2456 2387 2383 2384 2360 2361 2362 1556 1554 2170 2174 
		2173 2171 2161 2160 2163 2162 2164 2168 2167 2172 2165 2166 2169



	
	#New Trade Nodes
	1438 1511 1539 1607
}

oceania = {

}

island_check_provinces = {
	4296 # Bitlis- Europe/Asia/Africa
	852  # Mexico - America
	1084 # Wadjuk - West Australia
	1092 # Bundjalung - East Australia
	2728 # Tiwi - North Australia
}

# Used for RNW
new_world = {
}