
golden_highway_bulwar_proper = {
	565 567 572 561 584 596 598 600 601 602 608 613 628
}
golden_highway_far_bulwar = {
	625 626 627 631 634 639 640 641 642 643 647 558 585
}
golden_highway_far_salahad = {
	2900 2901 2902 2905 2908 2910 2913
}
golden_highway_rahen_coast = {
	4361 4363 4368 4379 4412 4411 4410 4381 4404 4391 4392 4418 4399 4420 4406 
}
golden_highway_dhujat = {
	4408 4409 4492 4496 4493 4497 4499
}
golden_highway_xianjie = {
	4470 4489 4500 4620 4511 4611 4938 4613 4559 4617 4618 4641 4817 4819
}
golden_highway_upper_yanshen = {
	4826 4952 4842 4845 4850 4846 4853 4854 4859 4861
}
golden_highway_lower_yanshen = {
	4873 4867 4868 4869 4870 4871
}

irrigation_dwarovar = {
	4125 4129 4123 4142 4131 4143 4158 4151 4152 4166 4164 4145
}

adbrabohvi_dam_near = {
	1133 1144 1137 2816 1142 1136 2861 1825 1826 1827 2859 1143 2858 1135 1877 1134 1874 2860 1830 1832 1833 1834 1822
}

adbrabohvi_dam_far = {
	1839 1838 1852 1853 2729 1840 1854 1855 1856 1860 1859 1857 1858 1841 1828 2857 1829 1831 1843
}

vels_bacar_dam_near = {
	2810 1821 1878 2811 1166 2837 2809 1819 1820 1824 2811 1166 2813 1167 2812 1187 1138 1837 2781 1140 1139 1148
}

vels_bacar_dam_far = {
	1149 1155 2783 2841 1150 2817 1154 1151 2606 2615 2844 1157 1156 2818 2784 1161 1158 1159 2815 2807 1160 1147 1146
}

bosancovac_dam_near = {
	1165 2839 1171 2814 2862 2840 2488 1172 1180 2742
}

bosancovac_dam_far = {
	1163 1164 2819 1162 1176 
}

mocbarja_dam_near = {
	1188 1170 1182 1168 1169 2808 1186
}

mocbarja_dam_far = {
	1851 1850 1848 1849 1847 2842 1846 1823 1800 1816 1815 2843 1817 1818 2838 1755
}

west_dolindha = {
	1823 2842 1824 1818 1820 1819 2809 1187 1188 1186 2813 1167 2808 2812 1168 1169 1170 1182 1755 2838
}

east_dolindha = {
	1166 2811 2837 1165 2862 2839 1172 2814 1171 1180 2742 2840 2488
}

west_ynn_bank = {
	1187 1818 1819 1820 1821 1822 1823 1824 1825 1826 1827 1828 1829 1830 1831 1832 1833 1834 1835 1837 1838 1839 1840 1841 1843 1844 1858 1878 2809 2842 2857
}

east_ynn_bank = {
	2757 1133 1145 1144 1135 1877 1134 1874 2860 1137 1138 2816 1142 1136 1149 1148 1155 1139 1140 1141 2841 2810 2861 2859 1143 2858
}

ynn_riverside = {
	1191 1190 1189 1168 2812 2813 1165 2837 1140 1138 1137 1136 1133 2757 2781 1835 1833 1830 1829 1828 1817 1816 1815 2843 1188 1186 1187 2809 1819 1820 2811 1166 1821 1878 1822 1135 1877 1134 2860 1827 1826 1825
}

deepwoods_cluster_1 = {
	3005 3004 3006 3007 3008
}

deepwoods_cluster_2 = {
	3018 3019 3020 3021 3022
}

deepwoods_cluster_3 = {
	3013 3014 3015 3016 3017
}

deepwoods_cluster_4 = {
	3009 3010 3011 3012 3067
}

deepwoods_cluster_5 = {
	3027 3028 3029 3030 3031
}

deepwoods_cluster_6 = {
	3023 3024 3025 3026
}

deepwoods_cluster_7 = {
	3032 3033 3034 3035 3036 3037 3038
}

deepwoods_cluster_8 = {
	3039 3040 3041 3042
}

deepwoods_cluster_9 = {
	3043 3044 3045 3046 3047
}

deepwoods_outward_gladeway = {
	3071 3048 3054 3068 3065 3064 3069 3070
}

harimraj_core_lands = {
	4390 4418 4419 4417 4392 4393 4391 4421 4422 4425 4424 4423 4416 4404 4394 4405 4410 4413 4438
	4415 4414 4412 4411 4385 4379 4378 4368 4426 4428 4429 4432 4431 4430 4427 4433 4434 4435 4436 4441
	4399 4398 4406 4407 4408 4490 4373 4401 4381
}

east_alecand = {
	2756 2726 2758 2759 2727 2728 2761 2730 2762 2763 2731 2765 2764 2732 2767 2768 2733 2734 2735 2725 2724 2770
	2769 2736 2771 2737 2738 2775 2776 2777 2773 2772 2739 2745 2778 2743 2744
}

alen_river_cities = {
	216 219 337 220 339 221 222 223 225 226
}

western_alenic_reach = {
	721 707 706 722 704 705 723 752 731 702 703 724 700 699 696 695 694 697 698
}

lupulan_rainforest_interior = {
	4719 4721 4725 4726 4723 4724 4766 4735 4964 4733 4732 4772 4730 4956 4957 4953 4959 4741 4965 4736 4765 4710 4734 4737 4713 4767 4712 4768 4708 4769
}

porcelain_cities = {	#added Nundujisbid, which can become a porcelain city later and starts with the trade good
	4470 4500 4600 4493 4396 4409
}
suran_river = {
	565 567 572 561 584 596 598 600 601 604 607 612 625 627 631 634 639 640 641 642 643 
}


seiche_1 = {
	5305 5229 5297 5296 5295 5289 5306
}

seiche_2 = {
	5278 5277 5276 5273 5271 5270
}

seiche_3 = {
	5259 5258 5257 5256 5252
}

seiche_4 = {
	5237 5236 5235 5234 5233 5229
}

triunic_crescent = {
	5224 5223 5195 5191 5190 5189 5188 5187 5180 5167 5166 5164 5163 5160 5158 5156 5151 5149 5146 5145 5141 5140 5135 5138 5137 5134 5130 5129 5126 5125 5123 5285
	5284 5283 5282 5304 5281 5280 5302 5300 5305 5229 5297 5296 5295 5289 5306 5286 5278 5277 5276 5273 5271 5270 5269 5267 5265 5264 5263 5262 5261 5259 5258 5257 
	5256 5252 5251 5249 5247 5246 5242 5241 5238 5236 5237 5236 5235 5234 5233 5229 
	5274 5275 5291 5292 5293 5294 5301 5279 5272 5268 5254 5250 5248 5247 5246 5245 5244 5121 5119 5117 5115 5116 5018 5011 5010 5008 5320 5321 5323 5108 
}

lake_shore = {
	5110 5111 5113 5112
}

wild_clan_lands = {
	5024 5019 5021 5020 5022 5005
}

triunic_road = {
	5203 5199 5198 5197 5194 5195 5183 5177 5174 5173 5171 5170 5188 5187 5186 5185 5192 5169 5166 5164 5162 5159 5157 5155 5151 5150 5148 5089 5085 5146
	5144 5142 5139 5132 5133 5130 5128 5071 5074 5073 5092 5093 5094 5096 5099 5127 5067 5113 5112 5123 5122 5120 5063 5059 5058 5062 5061 5015 5013 5004 5303
	5088 5103 5104 5105 4117
}

luna_river_basin = {
	898 299 298 296 327 906 329 587 109 394 282 284 295 287 25 45 50 569 285 331
}

hold_province = {
	62 526 4149 4119 4128 4122 4208 2868 2931 4236 4056 4039 2973
	4093 4217 4218 4078 4247 4284 4350 4311 4313 4265 4266 4323 2863 4097 2963 4100 2942 4238 4124 2914 912 4020 4147 5424
}

road_province = {
	263 3003 3002 3001 3000 2999 2998 2997 2996 2994 2993 2992 2991 2990 2989 2988
	2864 2935 2865 2866 2867 2871 4043 2872 2933 2873 2874 2934 4065 4153 2875 2876 4104 2932 2877
	2937 2878 2879 4103 2880 2881 2882 2883 4029 2884 4038 4037 4036 2985 2984 2980 2981 2979 2970
	2968 4240 2962 2946 2945 2944 2943 2955 2954 2956 2957 2987 2885 4028 2886 2887 2888 2889
	2890 2891 4027 2892 2893 2894 2895 4231 4091 4111 4112 4113 4114 4090 2969 4082 2986 4121
	4120
	
	4242 4243 4244 4245 4246 4248 4249 4250 4251 4252 4253 4254 4255 4256 4257 4258 4259 4260 
	4261 4262 4263 4264 4297 4298 4300 4301 4302 4303 4304 4305 4306 4307 4308 4309 4310
	4314 4315 4316 4317 4318 4319 4320 4356 4359 4360 4312
}

cavern_province = {
	185 186 187 189 4643 4644 4645 4646 4211 4210 4209 4186 4185 4187 4188 4118 4130 4148 4144 4141 4064 4063
	4062 4150 4213 4212 4165 2897 2896 2898 2899 2870 2869 4163 4022 2995 4021 4023 4025 4024 4026
	4074 4096 4054 4044 4045 4046 4047 4048 4049 4055 4050 4051 4052 4053 4067 4066 4061 4060 4059 4058
	4057 4076 4075 4077 4105 4237 4068 4069 4070 4071 4072 4073 4153 4102 4040 4042 4041 2949 2951 2952 
	4035 2982 2978 2983 2977 2974 4099 2975 4098 2976 2972 2971 4126 2967 2964 2966 2965 4127 2961 2959 
	2958 2960 2947 2948 2950 4032 4034 4031 4033 2941 4030 2939 2940 4227 4228 4229 4215 4214 4080 4239 
	4084 4079 4081 4083 4216 4085 4230 4088 4110 4086 4087 4108 4109 4107 4106 4092 4095 4094
	4089 4220 4219 4221 4222 4223 4101 4203 4207 4206 4205 4204
	
	4277 4277 4279 4280 4281 4271 4267 4282 4269 4270 4272 4292 4274 4275 4268 4283 4285 4287
	4286 4288 4293 4294 4295 4296 4299 4278 4273 4290 4289 4291 4332 4344 4354 4345 4355 4342 4341 4340
	4339 4338 4337 4336 4335 4334 4351 4352 4348 4349 4324 4325 4326 4353 4327 4329 4330 4331
	
	3070 3069
}

dagrinrod_province = {
	3003 3002 3001 3000 2999 2998 2997 2996 2994 2993 2992 2991 2990 2989 2988 2876 4104
}

city_province = {
	8 #Anbenncost
	52 #Port Munas
	63 66 #Viswall
	67 #Lorentaine
	101 #Wineport
	126 #Portnamm
	151 #Beepeck
	216 #Vertesk
	266 #Esmaraine
	328 #Silvelar
	327 #Cestaire
	234 #Damescrown
	294 #Magdalaire
	451 #Nathalaire
	565 #Brasan
	569 #Menibor
	587 #Bellacaire
	831 832 833 #Castonath
	141 165 723
	33 26 15 329 331 365 911 249 915 112 601 271 164 417
	
	#Kheterata
	475 
	
	#Rahen
	4364 4367 4380 4435 4411 4391 4420 4409 4489 4493 4485 4470
	4500 4510 4460 4397
	
	#Haless
	4570 4580 4560 4600 4620 4633 4396 4941 4962 4963
	
	#Yanshen
	4871 4868 4859 4846 4842 4826
	
	#Aelantir
	2007 2728 2731 2732 2736 2738 2773 2745 2495 2496 2497 2520 1139 1171 1191
	
	#Forbidden Lands
	5295 5293 5276 5253 5257 5256 5238 5237 5226 5304 5305 5287
}

# Castanor MT
white_walls = {
	746 747 754 755 756 828 829 830 837 850 855 860 862 865 866 869 873 874
}
dragon_road = {
	829 830 821 825 820 809 801 800 807 803 441 440 431 428 443 446 447
}
legionway_inner_castanor = {
	829 830 834 835 839 837 754 841 853 855 865 840 847 849 828
}
legionway_south_castanor = {
	803 807 800 801 809 820 821 822 817 818 876 885 888 827 826 824 795 796 441
}
legionway_west_castanor = {
	780 782 774 773 764 767 756 785 753 751 749 729 725 726 229 783 788 790 
}
legionway_to_bal_vroren = {
	748 744 742 738 737 740
}
legionway_bal_vroren_to_konungrhaven_citadel = {
	987 986 984 983 982 980 978 977 975 973 972 974 954 956
}
legionway_bal_mire_to_bal_vertesk = {
	226 227 228 225 223 222 221 220 339 337 219 216
}
legionway_bal_vertesk_to_foddimad_citadel = {
	211 212 336 150 167 170 183
}
legionway_bal_vertesk_to_bal_hyl = {
	251 249 915 233 234 255 259 260 266 268 271 909 901 302 303
}
legionway_bal_dostan_to_bal_hyl = {
	440 431 430 428 427 323 324 325 904 305 306
}
legionway_forlorn_vale = {
	777 778 263 356 359 352
}
legionway_dragon_coast_to_redfort_citadel = {
	210 209 207 205 157 152 158 133 71 70 153 156 18 28 10 15 20 59 68 67
}
legionway_dragon_coast_to_daromsfort_citadel = {
	145 144 103 141 143 142 129 126 128 123 121 112 110 102 58
}
legionway_to_bal_ouord = {
	510 507 506 448 447 446 442
}
legionway_bal_ouord_to_gelkalis = {
	512 513 520 529 530 531 535 536 541 543 547 545 550 651 654 653 655 665 652
}
legionway_gelkalis_to_anzabad = {
	610 591 588 586 560 664 663
}
legionway_anzabad_to_sorrowgate = {
	568 679 680 501 500 499 498 497 495 493 492 490 465 546 467 468 466 464
}
legionway_gelkalis_to_azka_sur = {
	668 671 618 616 622 624
}
legionway_gelkalis_to_sorrowgate = {
	610 603 568 679 680 501 500 499 498 497 495 493 492 490 465 546 467 468 466 464
}
castanorians_citadels_including_new_from_mt = {
	306 441 510 216 229 740 # Original 6
	956 183 3 665 468 560 643 68 58
}
castanorian_citadels = {
	306 441 510 216 229 740
}
runedaddy_province = {
	4074 #Asra Depths
	4050 #Trueforge Hall
	4063 #Cartsfall
	4148 #Lord's Gorge
	4057 #Blackden Rift
	4041 #Molten Core
	2971 #Dead Dwarf Depths
	2947 #Greater Mines
	2940 #Ranger's Post
	4214 #Hehogrim's Mausoleum
	4109 #Kradoz Breach
	4222 #Old Excavation
	4269 #Earthseed
	4296 #Alemine
}