
golden_highway_bulwar_proper = {
	565 567 572 561 584 596 598 600 601 602 608 613 628
}
golden_highway_far_bulwar = {
	625 626 627 631 634 639 640 641 642 643 647 558 585
}
golden_highway_far_salahad = {
	2900 2901 2902 2905 2908 2910 2913
}
golden_highway_rahen_coast = {
	4361 4363 4368 4379 4412 4411 4410 4404 4391 4392 4418 4399 4420 4406 
}
golden_highway_dhujat = {
	4408 4409 4492 4496 4493 4497 4499
}
golden_highway_xianjie = {
	4470 4489 4500 4620 4511 4611 4938 4613 4559 4617 4618 4641 4817 4819
}
golden_highway_upper_yanshen = {
	4826 4952 4842 4845 4850 4846 4853 4854 4859 4861
}
golden_highway_lower_yanshen = {
	4873 4867 4868 4869 4870 4871
}

irrigation_dwarovar = {
	4125 4129 4123 4142 4131 4143 4158 4151 4152 4166 4164 4145
}

west_dolindha = {
	1823 2842 1824 1818 1820 1819 2809 1187 1188 1186 2813 1167 2808 2812 1168 1169 1170 1182 1755
}

east_dolindha = {
	1166 2811 2837 1165 2862 2839 1172 2814 1171 1180 2742 2840 2488 2838
}

deepwoods_cluster_1 = {
	3005 3004 3006 3007 3008
}

deepwoods_cluster_2 = {
	3018 3019 3020 3021 3022
}

deepwoods_cluster_3 = {
	3013 3014 3015 3016 3017
}

deepwoods_cluster_4 = {
	3009 3010 3011 3012 3067
}

deepwoods_cluster_5 = {
	3027 3028 3029 3030 3031
}

deepwoods_cluster_6 = {
	3023 3024 3025 3026
}

deepwoods_cluster_7 = {
	3032 3033 3034 3035 3036 3037 3038
}

deepwoods_cluster_8 = {
	3039 3040 3041 3042
}

deepwoods_cluster_9 = {
	3043 3044 3045 3046 3047
}

deepwoods_outward_gladeway = {
	3071 3048 3054 3068 3065 3064 3069 3070
}

harimraj_core_lands = {
	4390 4418 4419 4417 4392 4393 4391 4421 4422 4425 4424 4423 4416 4404 4394 4405 4410 4413 4438
	4415 4414 4412 4411 4385 4379 4378 4368 4426 4428 4429 4432 4431 4430 4427 4433 4434 4435 4436 4441
	4399 4398 4406 4407 4408 4490
}

east_alecand = {
	2756 2726 2758 2759 2727 2728 2761 2730 2762 2763 2731 2765 2764 2732 2767 2768 2733 2734 2735 2725 2724 2770
	2769 2736 2771 2737 2738 2775 2776 2777 2773 2772 2739 2745 2778 2743 2744
}

alen_river_cities = {
	216 219 337 220 339 221 222 223 225 226
}

western_alenic_reach = {
	707 721 706 722 704 705 723 752 731 702 703 724 700 699 696 695 694 697 698
}

lupulan_rainforest_interior = {
	4719 4721 4725 4726 4723 4724 4766 4735 4964 4733 4732 4772 4730 4956 4957 4953 4959 4741 4965 4736 4765 4710 4734 4737 4713 4767 4712 4768 4708 4769
}

porcelain_cities = {	#added Nundujisbid, which can become a porcelain city later and starts with the trade good
	4470 4500 4600 4493 4396 4409
}
suran_river = {
	565 567 572 561 584 596 598 600 601 604 607 612 625 627 631 634 639 640 641 642 643 
}


seiche_1 = {
	5305 5229 5297 5296 5295 5289 5306
}

seiche_2 = {
	5278 5277 5276 5273 5271 5270
}

seiche_3 = {
	5259 5258 5257 5256 5252
}

seiche_4 = {
	5237 5236 5235 5234 5233 5229
}

triunic_crescent = {
	5224 5223 5195 5191 5190 5189 5188 5187 5180 5167 5166 5164 5163 5160 5158 5156 5151 5149 5146 5145 5141 5140 5135 5138 5137 5134 5130 5129 5126 5125 5123 5285
	5284 5283 5282 5304 5281 5280 5302 5300 5305 5229 5297 5296 5295 5289 5306 5286 5278 5277 5276 5273 5271 5270 5269 5267 5265 5264 5263 5262 5261 5259 5258 5257 
	5256 5252 5251 5249 5247 5246 5242 5241 5238 5236 5237 5236 5235 5234 5233 5229 
	5274 5275 5291 5292 5293 5294 5301 5279 5272 5268 5254 5250 5248 5247 5246 5245 5244 5121 5119 5117 5115 5116 5018 5011 5010 5008 5320 5321 5323 5108 
}

lake_shore = {
	5110 5111 5113 5112
}

wild_clan_lands = {
	5024 5019 5021 5020 5022 5005
}